+--+--+--+--+--+--+--+--+--+--+--+--+--+--+--+--+--+--+--+--+--+--+--+--+--+--+--+--+--+  +--+--+--+--+--+--+--+--+--+--+--+--+--+--+--+--+--+--+--+--+--+--+--+--+--+--+--+--+--+
|     |     |        |        |        |              |              |           |                 |     |  |                 |  |     |  |        |     |                       |
+  +  +--+  +  +--+--+  +--+  +  +  +  +--+  +--+  +  +--+  +--+--+  +--+--+  +  +--+--+--+--+--+  +  +  +  +  +--+--+--+--+  +  +  +  +  +  +  +  +  +  +  +  +  +--+--+--+--+  +
|  |        |              |     |  |        |     |  |     |     |  |     |  |  |        |  |     |  |  |  |        |     |        |  |     |  |  |  |     |  |  |              |
+  +--+--+--+--+--+--+--+  +--+--+--+--+--+--+--+--+  +  +--+--+  +  +  +  +  +  +  +--+  +  +  +--+  +  +  +--+--+  +  +  +--+--+--+  +--+--+  +  +  +--+--+--+  +  +--+--+--+  +
|     |  |              |     |           |           |  |     |     |  |     |  |     |           |  |     |     |     |           |        |  |        |        |     |        |
+--+  +  +  +--+--+--+  +  +  +  +--+--+  +--+--+--+--+  +  +  +--+--+  +--+--+  +  +--+--+--+--+  +  +--+  +  +  +--+--+--+--+--+  +--+--+  +--+--+--+--+  +--+--+--+  +  +--+--+
|        |  |              |  |  |     |                 |  |  |     |  |  |     |     |        |  |     |     |              |     |        |           |  |     |     |  |     |
+  +  +--+  +  +--+--+--+--+  +  +  +  +--+--+--+--+--+--+  +  +--+  +  +  +  +--+--+  +  +--+  +  +--+  +--+--+--+--+--+--+--+  +--+--+--+--+  +  +--+  +  +  +--+  +--+  +  +  +
|  |  |     |  |        |           |           |        |  |        |  |     |     |     |  |  |     |  |           |     |     |           |  |     |     |     |     |  |  |  |
+  +--+  +  +--+  +--+  +  +--+--+--+--+--+--+  +  +--+  +  +--+--+  +  +  +--+--+  +--+  +  +  +--+  +  +  +--+--+  +--+  +  +--+  +--+--+  +--+--+  +--+--+--+  +--+  +  +  +  +
|  |     |  |     |     |     |           |  |  |  |  |     |        |  |     |        |  |  |  |        |        |        |     |  |     |                 |     |  |  |     |  |
+  +  +--+--+  +--+  +  +--+  +  +--+--+  +  +  +  +  +--+--+  +--+--+--+  +--+  +--+--+  +  +  +--+--+--+--+  +  +--+--+--+  +--+  +  +  +--+--+--+--+--+  +  +  +  +  +--+--+  +
|        |     |     |     |     |        |     |  |     |                 |        |     |     |        |     |  |  |     |  |     |  |        |        |  |  |     |     |  |  |
+--+--+  +  +  +  +--+--+--+--+--+--+--+--+  +--+  +--+  +  +--+--+--+--+--+  +--+  +  +--+--+--+  +--+  +--+  +  +  +  +  +  +  +--+  +--+--+  +  +--+  +--+  +--+--+--+  +  +  +
|     |  |  |  |     |           |        |     |        |        |        |     |  |              |     |     |        |     |              |  |  |        |  |     |  |  |     |
+  +  +--+  +--+--+  +  +  +--+  +  +  +--+--+  +--+--+  +--+  +--+  +--+  +  +  +--+--+--+  +--+--+--+--+  +  +  +--+--+--+  +--+--+--+--+  +--+  +  +--+  +  +  +  +  +  +--+  +
|  |  |        |  |     |  |     |  |     |  |           |     |     |     |  |     |     |                 |  |           |  |        |  |        |     |  |  |  |     |  |     |
+  +  +  +--+  +  +--+--+  +--+--+  +--+  +  +--+  +--+  +  +--+  +--+  +  +--+--+  +  +  +--+--+--+--+--+--+--+--+--+--+  +  +  +--+  +  +--+--+--+  +  +--+  +  +--+--+  +  +--+
|  |  |     |  |        |     |     |        |     |  |  |        |     |           |  |  |           |     |     |        |  |     |     |           |        |     |     |     |
+  +  +--+  +  +--+--+  +--+  +  +  +--+--+  +  +--+  +  +--+--+--+--+--+--+--+--+--+  +  +  +--+--+--+  +  +  +  +  +--+--+  +  +--+  +  +--+--+--+--+--+--+  +--+  +--+  +--+  +
|  |        |        |     |  |  |     |     |  |  |     |           |     |           |     |        |  |     |  |     |        |     |                    |        |     |  |  |
+  +--+--+--+--+--+  +--+  +  +  +--+  +--+--+  +  +  +--+  +--+--+  +  +  +  +--+--+--+--+--+  +--+  +--+--+--+  +--+  +  +--+--+  +--+--+--+--+--+--+  +  +--+--+--+  +--+  +  +
|     |     |     |     |  |  |     |        |     |     |        |     |  |        |     |     |     |     |     |     |  |  |     |           |        |     |     |  |     |  |
+--+--+  +  +  +  +  +  +  +  +--+  +--+--+  +--+  +--+  +--+--+--+  +--+--+  +--+  +--+  +  +--+  +--+  +  +--+  +  +--+  +  +  +  +  +--+--+  +--+--+--+--+  +  +  +  +  +  +  +
|        |  |  |  |  |  |  |        |     |        |     |     |        |     |     |     |  |     |     |        |  |     |  |  |     |     |              |  |  |     |  |     |
+  +  +--+  +  +  +--+  +  +--+  +--+--+  +--+--+--+  +--+  +  +  +  +  +  +--+--+  +  +--+  +  +--+--+  +--+--+--+  +  +--+  +  +--+--+  +  +--+--+  +--+  +--+  +--+--+  +--+  +
|  |  |     |  |  |     |     |           |           |     |  |  |  |     |        |        |           |     |     |  |        |     |  |  |        |     |     |     |     |  |
+  +--+  +--+  +  +  +--+--+  +--+--+--+--+--+  +--+--+--+--+  +  +--+--+--+  +--+  +  +  +--+--+--+--+--+  +--+  +--+  +  +--+  +  +  +  +  +  +--+--+--+--+  +--+  +  +--+  +  +
|  |        |  |  |        |     |     |        |     |     |  |        |     |  |     |     |     |     |           |  |     |     |  |  |  |     |     |        |  |     |  |  |
+  +  +--+--+  +--+--+--+  +--+  +  +--+  +--+--+  +  +  +  +  +--+--+  +--+--+  +--+--+--+  +  +  +  +  +--+--+--+  +--+--+  +--+  +  +  +  +--+  +  +  +  +--+--+  +  +--+  +  +
|  |  |     |                 |  |     |        |  |     |        |        |     |        |  |  |  |  |     |        |     |  |     |  |  |     |  |  |     |  |     |     |  |  |
+  +  +  +  +--+--+  +  +--+  +  +  +  +--+--+  +  +--+--+--+  +  +--+--+  +  +--+  +--+  +  +  +--+  +--+  +  +--+--+  +  +  +  +--+  +  +--+  +  +  +--+--+  +  +--+--+  +  +  +
|  |     |     |     |     |  |  |  |     |     |  |     |     |        |  |        |     |  |     |  |     |     |     |  |  |     |  |  |  |  |     |                 |     |  |
+  +--+--+--+  +--+--+--+--+  +  +  +--+  +  +  +  +  +  +--+--+--+  +--+  +--+  +--+  +--+  +--+  +  +  +--+--+  +--+--+  +  +--+  +--+  +  +  +--+--+  +--+  +--+--+--+--+--+  +
|        |     |           |  |  |  |     |  |  |  |  |           |        |     |  |  |        |     |  |     |     |     |     |  |        |  |        |  |     |           |  |
+--+--+--+  +  +  +--+--+  +  +  +  +--+--+--+  +  +  +--+--+  +--+--+--+--+  +--+  +  +  +  +--+--+  +--+  +  +--+  +--+  +--+--+  +  +--+--+  +  +  +--+  +--+  +  +--+--+  +  +
|  |        |  |        |  |     |     |        |  |     |     |     |     |  |        |  |  |     |        |     |     |           |     |     |  |     |        |        |  |  |
+  +  +--+--+--+--+--+  +  +--+--+--+  +  +--+--+  +--+  +--+--+  +  +  +  +--+  +--+--+--+  +  +  +--+--+--+--+  +  +  +--+--+--+--+  +--+  +--+  +--+  +--+--+--+  +--+  +  +  +
|  |                    |     |     |  |  |        |        |     |  |  |  |     |           |  |        |           |  |        |        |     |  |     |     |  |     |  |     |
+  +--+--+--+--+--+--+--+--+  +  +--+  +  +  +  +  +  +--+  +  +  +--+  +--+  +--+--+--+--+--+  +--+--+  +  +--+--+--+  +--+  +  +--+--+  +--+  +  +  +--+  +  +  +--+  +  +--+--+
|        |                    |        |  |  |  |  |     |  |  |           |           |        |     |  |  |     |     |     |     |     |     |  |        |  |        |  |     |
+--+  +  +  +--+--+--+--+--+--+--+  +  +  +--+  +  +--+--+  +--+--+--+--+  +  +  +--+  +  +  +--+  +  +  +--+  +  +--+--+  +--+--+  +  +--+  +--+  +--+--+--+  +--+  +--+  +--+  +
|     |  |        |           |  |  |  |        |     |     |           |  |  |  |     |  |        |  |        |     |  |        |     |     |     |     |     |  |  |     |     |
+  +--+--+--+  +  +--+  +--+  +  +  +--+  +--+--+  +  +  +--+  +--+--+  +  +  +  +  +--+  +--+--+  +--+--+  +--+--+  +  +--+--+  +--+--+--+--+  +--+  +  +  +  +  +  +  +--+  +--+
|  |     |     |        |     |        |     |     |  |  |     |     |     |  |  |        |        |     |     |  |     |  |        |     |     |     |     |  |     |     |     |
+  +  +  +  +--+--+--+--+--+--+--+  +  +--+  +--+--+  +  +  +--+--+  +--+--+--+  +--+  +--+  +  +--+  +  +--+  +  +  +  +  +  +--+  +  +  +  +--+--+--+--+--+--+--+--+--+  +  +  +
|  |  |     |           |        |  |     |  |     |  |     |     |     |           |  |     |  |     |        |  |  |     |     |     |  |           |        |           |  |  |
+  +  +--+--+  +--+--+  +  +--+  +  +--+  +  +  +  +  +  +--+  +  +  +  +  +--+--+  +  +--+--+--+  +--+--+--+--+  +  +--+--+  +--+--+--+  +--+  +  +  +--+--+  +  +--+--+--+  +--+
|  |           |     |  |  |     |     |  |  |  |     |        |  |  |     |        |           |              |     |     |     |     |        |  |        |     |        |     |
+  +--+--+  +--+  +  +  +  +  +--+--+--+  +  +  +--+  +  +--+--+  +  +--+  +--+--+--+--+--+--+  +--+--+  +  +  +--+--+  +  +--+  +  +--+--+--+--+  +  +  +  +--+--+  +--+  +--+  +
|  |     |  |     |  |     |     |     |     |  |  |  |        |  |  |  |  |        |        |  |     |  |  |  |        |  |  |  |        |     |  |  |  |        |  |     |     |
+  +  +  +  +  +--+  +--+--+  +  +  +  +--+--+  +  +  +--+--+  +  +  +  +  +  +--+  +--+--+  +  +--+  +  +  +  +  +--+--+  +  +  +--+  +  +  +  +--+  +--+  +--+--+  +--+  +  +  +
|  |  |  |  |  |     |        |  |  |  |           |     |     |  |     |     |  |  |        |     |     |  |     |        |  |     |  |  |  |           |        |     |     |  |
+  +  +  +  +  +--+--+  +--+--+--+  +--+  +--+--+  +--+  +--+  +  +--+--+  +--+  +  +  +--+--+--+  +--+--+  +--+--+  +--+--+  +--+  +  +--+  +--+--+  +  +--+--+  +--+  +  +--+--+
|     |  |  |              |     |     |  |     |     |     |  |           |        |        |     |     |        |  |        |  |     |     |     |  |        |     |  |  |     |
+--+--+  +--+--+--+--+--+  +--+  +--+  +  +  +  +--+  +--+  +  +--+--+--+--+  +--+--+--+--+  +  +--+  +  +--+--+  +  +--+  +--+  +--+  +  +--+  +  +--+  +--+--+--+  +--+  +  +  +
|     |           |     |  |           |     |     |  |     |  |           |     |        |     |     |           |     |     |     |  |     |  |  |     |        |     |     |  |
+  +  +--+  +--+  +  +  +  +  +--+--+--+--+--+--+  +  +  +--+  +--+--+--+  +--+  +--+  +  +--+--+--+--+--+--+--+--+--+  +--+  +--+  +--+--+  +  +  +  +--+  +--+--+--+  +  +  +  +
|  |        |     |  |  |     |     |     |        |  |     |     |     |  |     |     |  |        |                    |     |     |           |  |     |  |  |     |     |  |  |
+  +--+--+  +  +--+  +  +  +--+  +--+  +  +  +--+--+  +--+--+--+  +  +--+  +  +--+  +--+--+  +--+  +  +--+--+--+--+--+--+  +  +  +  +  +--+--+--+  +--+--+  +  +  +  +--+--+--+  +
|  |     |  |     |  |  |        |     |     |        |  |        |  |     |     |     |        |  |        |              |     |  |  |           |  |     |  |  |           |  |
+  +  +  +--+--+--+  +--+--+--+  +  +--+--+--+--+--+--+  +  +--+--+  +  +--+  +  +--+  +  +--+--+  +--+--+--+  +  +--+--+--+--+  +  +  +  +  +--+  +  +  +--+  +  +--+--+--+  +  +
|  |  |  |        |  |           |              |           |     |  |        |  |     |  |     |              |  |        |     |     |  |     |     |        |  |     |     |  |
+  +  +  +  +--+  +  +  +  +  +--+  +--+--+--+  +  +--+--+--+  +  +  +--+--+--+  +  +--+  +  +  +--+--+--+--+--+--+  +--+--+  +--+--+--+--+--+  +--+--+--+--+  +  +  +  +  +  +--+
|  |  |  |  |  |  |     |  |     |        |     |        |     |           |     |     |  |  |              |        |        |                 |              |     |  |  |     |
+  +  +--+  +  +  +--+--+  +--+  +--+--+  +  +--+--+--+  +  +--+--+--+--+  +  +--+--+  +  +  +--+--+--+--+  +  +--+  +--+  +--+--+  +--+--+--+  +  +  +--+--+--+--+--+  +--+--+  +
|  |           |        |  |        |     |  |           |        |     |     |     |     |           |     |     |        |        |        |  |  |     |  |     |     |     |  |
+  +--+--+--+--+--+--+  +  +  +--+  +  +--+  +  +--+--+--+--+--+  +  +  +--+--+  +  +--+--+--+--+--+  +--+  +--+  +--+--+--+--+--+--+  +--+  +  +--+--+  +  +  +--+  +  +  +--+  +
|     |              |  |  |  |     |     |     |              |     |           |     |     |     |     |     |     |        |     |     |  |           |  |        |  |  |     |
+--+  +  +--+--+  +--+  +--+  +  +--+--+--+--+--+  +--+--+  +  +--+  +--+--+--+--+--+  +  +  +  +  +--+  +--+  +--+  +  +--+  +  +  +  +  +  +--+--+--+--+  +--+--+--+  +  +  +--+
|     |     |     |        |  |  |        |     |  |     |  |     |  |     |     |  |  |  |     |     |     |     |  |  |     |  |  |  |  |              |  |  |     |  |     |  |
+--+  +  +--+  +--+  +--+  +  +  +  +--+  +  +  +  +--+  +  +--+--+  +  +  +  +  +  +  +  +--+--+--+  +--+--+--+  +  +  +  +--+--+  +  +  +--+--+--+  +  +  +  +  +  +  +--+--+  +
|     |  |     |  |     |     |     |     |  |  |     |  |     |     |  |     |  |  |  |        |     |           |  |  |        |     |     |     |  |     |     |  |     |     |
+  +--+  +  +--+  +  +--+--+--+  +--+  +  +  +  +--+  +  +--+  +  +--+  +--+--+  +  +  +--+  +  +--+  +  +--+--+--+  +--+--+--+  +--+  +--+  +  +  +  +--+--+--+  +  +--+  +  +--+
|        |     |     |        |  |     |  |  |        |  |     |  |     |        |  |        |     |     |        |                       |  |  |  |     |     |  |        |     |
+--+  +  +--+  +--+--+  +--+  +  +  +--+  +  +--+--+--+  +  +--+  +  +  +  +--+--+  +  +--+--+--+  +--+--+  +--+  +--+  +--+--+  +--+--+--+  +  +--+--+  +  +  +  +  +--+--+--+  +
|     |     |           |  |     |  |  |  |     |     |  |  |     |  |  |  |           |     |     |     |     |     |  |     |  |        |           |  |  |  |  |              |
+  +--+--+--+--+--+--+--+  +--+--+  +  +  +  +--+  +  +  +  +  +  +  +  +  +  +--+--+  +  +--+  +--+  +  +--+  +--+  +--+  +--+  +  +--+  +--+--+--+  +--+  +  +  +--+--+--+--+--+
|     |                 |        |  |     |        |  |  |  |  |  |  |  |  |     |     |     |        |        |  |           |  |     |           |     |  |  |  |              |
+--+  +  +--+--+  +--+  +--+--+  +  +  +--+  +--+--+--+  +  +  +--+  +  +  +--+  +--+--+--+  +--+--+--+--+--+--+  +  +--+--+  +  +--+  +--+--+  +--+--+  +  +  +  +  +--+--+--+  +
|     |        |  |     |        |  |     |  |     |     |  |        |  |  |  |  |     |     |  |     |           |  |  |     |        |        |     |  |  |     |        |     |
+  +--+--+--+--+  +  +  +  +--+  +  +--+  +  +  +  +  +--+  +--+--+--+--+  +  +  +  +  +  +--+  +  +  +--+  +--+  +  +  +  +--+--+--+--+  +  +--+  +--+  +  +--+--+--+--+  +  +--+
|  |     |        |  |     |     |     |  |  |  |     |     |     |     |     |     |     |        |     |  |     |  |     |     |        |        |     |     |     |  |  |  |  |
+  +--+  +  +--+--+--+--+--+  +--+--+  +--+  +  +--+--+--+  +  +  +--+  +  +--+--+--+--+--+--+--+  +--+  +  +  +--+  +  +--+  +  +  +--+--+--+--+  +  +--+--+  +  +  +  +  +  +  +
|        |     |           |  |  |     |     |        |     |  |        |        |           |     |     |  |     |  |     |  |  |     |           |  |     |     |  |     |  |  |
+--+--+--+--+  +--+--+--+  +  +  +  +  +  +--+  +--+  +  +--+  +--+--+--+--+--+  +--+--+--+  +  +--+  +--+  +  +  +--+  +  +--+  +  +--+  +--+--+--+  +  +  +  +--+  +--+--+  +  +
|     |     |     |     |     |  |  |     |  |  |     |     |  |  |     |  |        |        |  |  |  |     |  |     |  |        |     |  |           |  |  |  |     |        |  |
+  +--+  +--+--+  +  +  +--+--+  +  +--+  +  +  +  +--+--+  +  +  +  +  +  +  +--+  +  +--+  +  +  +  +  +--+--+--+  +  +--+--+--+--+  +  +--+--+--+--+  +  +--+  +--+  +--+--+  +
|     |           |  |           |     |  |     |           |     |  |     |  |  |     |     |     |  |        |  |  |  |           |  |  |           |  |        |     |        |
+--+  +  +--+--+  +  +--+--+--+--+--+  +  +--+--+--+--+--+--+--+  +  +  +--+  +  +--+--+  +  +--+--+  +--+--+  +  +  +  +  +--+--+  +  +--+  +--+--+  +  +--+--+--+  +  +  +  +--+
|     |     |  |  |        |     |     |        |              |     |  |        |     |  |  |        |     |     |  |  |        |  |        |     |     |           |  |  |     |
+  +--+--+  +  +  +--+--+  +  +  +  +--+--+--+  +  +--+  +--+  +--+--+  +  +--+--+  +  +--+  +  +--+--+  +  +--+--+  +--+  +--+  +--+--+--+--+--+  +  +--+--+  +--+--+  +  +--+  +
|     |  |     |  |  |     |  |     |           |     |     |     |     |           |  |     |  |     |  |                    |     |  |           |  |     |  |  |     |  |     |
+--+  +  +--+--+  +  +  +  +  +--+--+  +  +--+  +--+--+--+  +--+  +  +  +--+  +--+  +  +  +--+  +  +  +  +--+--+--+--+--+--+--+--+  +  +  +--+--+--+  +  +  +  +  +  +--+--+  +--+
|     |  |        |     |     |        |     |              |        |     |  |     |  |     |  |  |  |  |           |           |        |  |        |  |  |  |  |  |     |  |  |
+  +--+  +  +--+--+  +--+--+--+--+--+--+--+  +--+--+--+--+--+--+--+  +--+--+  +--+--+  +--+  +  +  +  +--+  +--+  +  +  +  +--+--+--+--+  +  +  +--+--+--+  +  +  +  +--+  +  +  +
|        |           |           |  |                       |        |     |     |     |  |  |     |        |     |  |  |     |     |     |     |        |     |     |     |     |
+--+--+  +--+  +--+--+  +  +--+  +  +  +--+--+--+--+--+--+--+  +--+--+  +  +--+  +--+--+  +  +  +--+  +--+--+--+--+  +--+  +  +  +--+  +  +--+  +--+--+  +--+--+  +--+  +--+--+  +
|        |     |        |     |  |  |              |        |  |        |  |     |     |  |     |     |     |              |     |     |     |        |     |  |     |           |
+  +--+--+  +--+  +--+--+--+  +  +  +--+--+--+--+  +  +--+  +  +  +  +--+  +  +--+  +  +  +--+--+--+--+  +--+  +--+--+--+--+--+--+  +  +--+  +--+--+  +--+  +  +--+  +--+  +--+--+
|              |     |     |  |           |     |  |  |     |     |     |     |     |  |        |     |        |                    |     |        |     |  |     |        |     |
+  +--+--+--+  +--+  +--+  +  +--+--+--+  +  +  +--+  +  +--+--+  +--+  +--+--+--+--+  +  +--+  +  +  +  +--+--+  +  +--+--+--+--+--+--+--+  +--+  +--+  +  +  +  +  +--+  +  +  +
|     |        |           |  |     |  |     |        |        |     |              |  |     |     |  |           |        |  |           |     |  |     |  |  |     |     |  |  |
+--+--+  +--+--+  +--+--+--+  +  +  +  +  +--+--+--+--+--+--+--+--+  +--+--+--+--+  +  +--+  +--+--+  +--+--+  +--+  +--+  +  +  +--+--+  +--+--+  +  +--+  +  +--+--+--+--+  +  +
|                 |  |     |     |     |                 |           |        |     |     |        |        |     |  |     |     |     |        |     |     |  |  |        |  |  |
+  +--+--+  +--+--+  +  +  +--+--+--+--+--+--+--+--+--+  +  +--+--+--+  +--+  +  +--+  +  +--+--+  +--+--+  +--+--+  +  +--+--+--+  +  +--+  +  +--+--+  +--+  +  +  +--+  +  +  +
|  |     |     |  |     |     |                 |        |  |           |        |     |     |  |  |     |     |     |  |           |     |  |  |     |        |  |     |     |  |
+--+  +--+  +  +  +--+--+  +--+  +--+--+--+--+  +  +--+--+  +  +--+--+--+--+--+--+  +  +--+  +  +  +--+  +--+  +  +--+--+  +--+--+--+  +  +  +  +--+  +--+  +--+  +--+  +  +--+  +
|        |  |  |        |     |           |  |     |        |                 |     |  |     |        |     |  |     |     |           |  |  |           |  |     |     |     |  |
+  +--+  +--+  +--+--+  +  +  +--+--+--+  +  +  +--+  +--+--+--+--+--+--+--+  +  +--+  +--+--+--+--+  +--+  +  +--+  +  +--+  +--+--+--+  +  +--+--+--+--+  +  +  +  +--+--+  +  +
|  |     |           |     |        |     |  |  |  |        |                 |     |  |              |  |     |  |  |     |  |           |        |     |     |  |     |     |  |
+  +  +--+  +--+  +  +--+--+--+--+  +  +--+  +  +  +--+--+  +--+--+--+--+--+  +--+  +  +  +  +--+--+  +  +--+  +  +  +  +  +  +  +--+--+--+--+  +  +  +  +--+--+  +--+--+  +  +  +
|  |        |     |  |        |     |        |     |     |           |     |        |     |  |  |     |        |  |  |  |  |  |              |  |  |  |        |  |        |  |  |
+--+--+  +--+  +--+  +  +--+  +  +--+--+  +--+--+--+  +--+  +--+--+  +  +--+--+--+--+--+--+  +  +  +--+--+--+  +  +  +  +--+  +--+  +--+  +  +  +  +  +--+--+  +  +  +--+--+--+  +
|     |  |  |     |  |     |  |        |                 |  |        |     |  |     |        |  |           |  |  |     |        |  |     |  |  |           |     |           |  |
+  +  +  +  +--+  +  +--+--+  +  +--+  +--+--+--+--+--+  +  +  +--+--+  +  +  +  +--+  +  +--+  +--+--+--+  +  +  +--+--+  +--+--+  +  +--+--+  +--+  +--+--+--+--+--+--+--+  +  +
|  |     |        |           |     |                    |  |           |     |        |     |              |  |           |        |           |                             |  |
+--+--+--+--+--+--+--+--+--+--+--+--+--+--+--+--+--+--+--+--+--+--+--+--+--+--+--+--+--+  +--+--+--+--+--+--+--+--+--+--+--+--+--+--+--+--+--+--+--+--+--+--+--+--+--+--+--+--+--+